NO textures/black.xpm
SO textures/black.xpm
WE textures/black.xpm
EA textures/black.xpm

F 184,113,39
C 51,198,227

111111111111111111111111111111
100000000000000000000000000001
101111111111110000000011100001
100000000000000000110000000001
100000000000000000110000000001
100000000001000000000100000001
101111110001110110000100100001
100000000000000000000111110001
101111110000100000000100000001
101000010000100000000000000001
101000010000100111111110000001
1010000100001000000000000000N1
101000010000100111111110000001
100000000000100000000000000001
100000110000100110000110000001
100000110000100000000000000001
100000000000100000000000000001
111111111111111111111111111001
101010101010111111111111111111
111111111111111111111111111111
